###############
#.............#
#.....##......#
#.....##......#
#.............#
#.............#
###############
